"filename", "language", "C", "JavaScript", "XML", "Makefile", "C++", "comment", "blank", "total"
"d:\NUEDC\project_3_Car_Learning\Patrol Car\Debug\Patrol Car_linkInfo.xml", "XML", 0, 0, 7054, 0, 0, 0, 1, 7055
"d:\NUEDC\project_3_Car_Learning\Patrol Car\Debug\app\buzzer\subdir_rules.mk", "Makefile", 0, 0, 0, 7, 0, 4, 5, 16
"d:\NUEDC\project_3_Car_Learning\Patrol Car\Debug\app\buzzer\subdir_vars.mk", "Makefile", 0, 0, 0, 13, 0, 4, 10, 27
"d:\NUEDC\project_3_Car_Learning\Patrol Car\Debug\app\encoder\subdir_rules.mk", "Makefile", 0, 0, 0, 7, 0, 4, 5, 16
"d:\NUEDC\project_3_Car_Learning\Patrol Car\Debug\app\encoder\subdir_vars.mk", "Makefile", 0, 0, 0, 13, 0, 4, 10, 27
"d:\NUEDC\project_3_Car_Learning\Patrol Car\Debug\app\hc_06\subdir_rules.mk", "Makefile", 0, 0, 0, 7, 0, 4, 5, 16
"d:\NUEDC\project_3_Car_Learning\Patrol Car\Debug\app\hc_06\subdir_vars.mk", "Makefile", 0, 0, 0, 13, 0, 4, 10, 27
"d:\NUEDC\project_3_Car_Learning\Patrol Car\Debug\app\motor\subdir_rules.mk", "Makefile", 0, 0, 0, 7, 0, 4, 5, 16
"d:\NUEDC\project_3_Car_Learning\Patrol Car\Debug\app\motor\subdir_vars.mk", "Makefile", 0, 0, 0, 13, 0, 4, 10, 27
"d:\NUEDC\project_3_Car_Learning\Patrol Car\Debug\app\mpu6050\subdir_rules.mk", "Makefile", 0, 0, 0, 7, 0, 4, 5, 16
"d:\NUEDC\project_3_Car_Learning\Patrol Car\Debug\app\mpu6050\subdir_vars.mk", "Makefile", 0, 0, 0, 13, 0, 4, 10, 27
"d:\NUEDC\project_3_Car_Learning\Patrol Car\Debug\app\tb6612\subdir_rules.mk", "Makefile", 0, 0, 0, 7, 0, 4, 5, 16
"d:\NUEDC\project_3_Car_Learning\Patrol Car\Debug\app\tb6612\subdir_vars.mk", "Makefile", 0, 0, 0, 13, 0, 4, 10, 27
"d:\NUEDC\project_3_Car_Learning\Patrol Car\Debug\app\tracking\subdir_rules.mk", "Makefile", 0, 0, 0, 7, 0, 4, 5, 16
"d:\NUEDC\project_3_Car_Learning\Patrol Car\Debug\app\tracking\subdir_vars.mk", "Makefile", 0, 0, 0, 13, 0, 4, 10, 27
"d:\NUEDC\project_3_Car_Learning\Patrol Car\Debug\delay\subdir_rules.mk", "Makefile", 0, 0, 0, 7, 0, 4, 5, 16
"d:\NUEDC\project_3_Car_Learning\Patrol Car\Debug\delay\subdir_vars.mk", "Makefile", 0, 0, 0, 13, 0, 4, 10, 27
"d:\NUEDC\project_3_Car_Learning\Patrol Car\Debug\device_linker.cmd", "C", 56, 0, 0, 0, 0, 0, 13, 69
"d:\NUEDC\project_3_Car_Learning\Patrol Car\Debug\lib\delay\subdir_rules.mk", "Makefile", 0, 0, 0, 7, 0, 4, 5, 16
"d:\NUEDC\project_3_Car_Learning\Patrol Car\Debug\lib\delay\subdir_vars.mk", "Makefile", 0, 0, 0, 13, 0, 4, 10, 27
"d:\NUEDC\project_3_Car_Learning\Patrol Car\Debug\lib\key\subdir_rules.mk", "Makefile", 0, 0, 0, 7, 0, 4, 5, 16
"d:\NUEDC\project_3_Car_Learning\Patrol Car\Debug\lib\key\subdir_vars.mk", "Makefile", 0, 0, 0, 13, 0, 4, 10, 27
"d:\NUEDC\project_3_Car_Learning\Patrol Car\Debug\lib\pid\subdir_rules.mk", "Makefile", 0, 0, 0, 7, 0, 4, 5, 16
"d:\NUEDC\project_3_Car_Learning\Patrol Car\Debug\lib\pid\subdir_vars.mk", "Makefile", 0, 0, 0, 13, 0, 4, 10, 27
"d:\NUEDC\project_3_Car_Learning\Patrol Car\Debug\lib\usart\subdir_rules.mk", "Makefile", 0, 0, 0, 7, 0, 4, 5, 16
"d:\NUEDC\project_3_Car_Learning\Patrol Car\Debug\lib\usart\subdir_vars.mk", "Makefile", 0, 0, 0, 13, 0, 4, 10, 27
"d:\NUEDC\project_3_Car_Learning\Patrol Car\Debug\makefile", "Makefile", 0, 0, 0, 162, 0, 8, 19, 189
"d:\NUEDC\project_3_Car_Learning\Patrol Car\Debug\objects.mk", "Makefile", 0, 0, 0, 2, 0, 3, 4, 9
"d:\NUEDC\project_3_Car_Learning\Patrol Car\Debug\sources.mk", "Makefile", 0, 0, 0, 132, 0, 4, 4, 140
"d:\NUEDC\project_3_Car_Learning\Patrol Car\Debug\subdir_rules.mk", "Makefile", 0, 0, 0, 31, 0, 4, 9, 44
"d:\NUEDC\project_3_Car_Learning\Patrol Car\Debug\subdir_vars.mk", "Makefile", 0, 0, 0, 49, 0, 4, 18, 71
"d:\NUEDC\project_3_Car_Learning\Patrol Car\Debug\temple_linkInfo.xml", "XML", 0, 0, 2882, 0, 0, 0, 1, 2883
"d:\NUEDC\project_3_Car_Learning\Patrol Car\Debug\ti_msp_dl_config.c", "C", 393, 0, 0, 0, 0, 4, 123, 520
"d:\NUEDC\project_3_Car_Learning\Patrol Car\Debug\ti_msp_dl_config.h", "C++", 0, 0, 0, 0, 216, 2, 45, 263
"d:\NUEDC\project_3_Car_Learning\Patrol Car\app\buzzer\buzzer.c", "C", 50, 0, 0, 0, 0, 7, 7, 64
"d:\NUEDC\project_3_Car_Learning\Patrol Car\app\buzzer\buzzer.h", "C++", 0, 0, 0, 0, 9, 5, 2, 16
"d:\NUEDC\project_3_Car_Learning\Patrol Car\app\encoder\encoder.c", "C", 92, 0, 0, 0, 0, 9, 11, 112
"d:\NUEDC\project_3_Car_Learning\Patrol Car\app\encoder\encoder.h", "C++", 0, 0, 0, 0, 9, 5, 3, 17
"d:\NUEDC\project_3_Car_Learning\Patrol Car\app\hc_06\hc_06.c", "C", 8, 0, 0, 0, 0, 0, 2, 10
"d:\NUEDC\project_3_Car_Learning\Patrol Car\app\hc_06\hc_06.h", "C++", 0, 0, 0, 0, 7, 3, 3, 13
"d:\NUEDC\project_3_Car_Learning\Patrol Car\app\motor\motor.c", "C", 135, 0, 0, 0, 0, 4, 14, 153
"d:\NUEDC\project_3_Car_Learning\Patrol Car\app\motor\motor.h", "C++", 0, 0, 0, 0, 20, 8, 1, 29
"d:\NUEDC\project_3_Car_Learning\Patrol Car\app\mpu6050\mpu6050.c", "C", 355, 0, 0, 0, 0, 25, 45, 425
"d:\NUEDC\project_3_Car_Learning\Patrol Car\app\mpu6050\mpu6050.h", "C++", 0, 0, 0, 0, 68, 24, 15, 107
"d:\NUEDC\project_3_Car_Learning\Patrol Car\app\tb6612\tb6612.c", "C", 73, 0, 0, 0, 0, 10, 7, 90
"d:\NUEDC\project_3_Car_Learning\Patrol Car\app\tb6612\tb6612.h", "C++", 0, 0, 0, 0, 12, 8, 4, 24
"d:\NUEDC\project_3_Car_Learning\Patrol Car\app\tracking\tracking.c", "C", 64, 0, 0, 0, 0, 2, 8, 74
"d:\NUEDC\project_3_Car_Learning\Patrol Car\app\tracking\tracking.h", "C++", 0, 0, 0, 0, 7, 0, 1, 8
"d:\NUEDC\project_3_Car_Learning\Patrol Car\lib\delay\delay.c", "C", 61, 0, 0, 0, 0, 3, 12, 76
"d:\NUEDC\project_3_Car_Learning\Patrol Car\lib\delay\delay.h", "C++", 0, 0, 0, 0, 8, 4, 34, 46
"d:\NUEDC\project_3_Car_Learning\Patrol Car\lib\key\key.c", "C", 155, 0, 0, 0, 0, 9, 15, 179
"d:\NUEDC\project_3_Car_Learning\Patrol Car\lib\key\key.h", "C++", 0, 0, 0, 0, 43, 8, 11, 62
"d:\NUEDC\project_3_Car_Learning\Patrol Car\lib\pid\pid.c", "C", 72, 0, 0, 0, 0, 3, 11, 86
"d:\NUEDC\project_3_Car_Learning\Patrol Car\lib\pid\pid.h", "C++", 0, 0, 0, 0, 21, 6, 3, 30
"d:\NUEDC\project_3_Car_Learning\Patrol Car\lib\task\task.h", "C++", 0, 0, 0, 0, 35, 0, 4, 39
"d:\NUEDC\project_3_Car_Learning\Patrol Car\lib\usart\usart.c", "C", 142, 0, 0, 0, 0, 2, 14, 158
"d:\NUEDC\project_3_Car_Learning\Patrol Car\lib\usart\usart.h", "C++", 0, 0, 0, 0, 22, 9, 3, 34
"d:\NUEDC\project_3_Car_Learning\Patrol Car\main.c", "C", 186, 0, 0, 0, 0, 19, 12, 217
"d:\NUEDC\project_3_Car_Learning\Patrol Car\main.syscfg", "JavaScript", 0, 247, 0, 0, 0, 0, 20, 267
"Total", "-", 1842, 247, 9936, 616, 477, 298, 679, 14095